1 13 31
###############################
#  p   ** *  1 * 2 *  * * *   #
# # # #*# # #*#*# # # #*#*#*# #
#   * s   ***  *  1   *   * * #
# # # # # #*# # #*#*# # # # #*#
#f     s   x **  *  *    1    #
# # # # # # # # # #*# #*# # # #
#*  *      *  *      *        #
# # # # #*# # # #*#*# # # # # #
#*    **  *    2  *     x     #
# #*# # # # # # #*# # # # # # #
#           *   *  *          #
###############################